WWWWWWWWWWW
W.........W
W.WWWWWWW.W
W.WWWWWWW.W
W.WW   WW.W
WOWW   WWOW
W.WW   WW.W
W.WWWWWWW.W
W.........W
WWWWWWWWWWW